1111111111111111111111111
1P00100000000000000000001
10001C0010000000001C00001
1000111110000000001111111
1000000000000000000000001
1111111111111000000000001
1000000000001000000000001
10001111111010000000000C1
1000100000101000000011111
10001C00000010000000100E1
1000111111111000000010001
1000000000000000000000001
1111111111111111111111111